+ +-+-+-+
| |   | |
+ + + + +
|   |   |
+-+-+ +-+
|     | |
+ +-+-+ +
|       |
+-+-+-+ +
